UUU	Fenilalanina (F)
UUC	Fenilalanina (F)
UUA	Leucina (L)
UUG	Leucina (L)
CUU	Leucina (L)
CUC	Leucina (L)
CUA	Leucina (L)
CUG	Leucina (L)
AUU	Isoleucina (I)
AUC	Isoleucina (I)
AUA	Isoleucina (I)
AUG	Metionina (M) – Códon de início
GUU	Valina (V)
GUC	Valina (V)
GUA	Valina (V)
GUG	Valina (V)
UCU	Serina (S)
UCC	Serina (S)
UCA	Serina (S)
UCG	Serina (S)
CCU	Prolina (P)
CCC	Prolina (P)
CCA	Prolina (P)
CCG	Prolina (P)
ACU	Treonina (T)
ACC	Treonina (T)
ACA	Treonina (T)
ACG	Treonina (T)
GCU	Alanina (A)
GCC	Alanina (A)
GCA	Alanina (A)
GCG	Alanina (A)
UAU	Tirosina (Y)
UAC	Tirosina (Y)
UAA	Códon de parada
UAG	Códon de parada
UGA	Códon de parada
CAU	Histidina (H)
CAC	Histidina (H)
CAA	Glutamina (Q)
CAG	Glutamina (Q)
AAU	Asparagina (N)
AAC	Asparagina (N)
AAA	Lisina (K)
AAG	Lisina (K)
GAU	Ácido aspártico (D)
GAC	Ácido aspártico (D)
GAA	Ácido glutâmico (E)
GAG	Ácido glutâmico (E)
UGU	Cisteína (C)
UGC	Cisteína (C)
GGU	Glicina (G)
GGC	Glicina (G)
GGA	Glicina (G)
GGG	Glicina (G)
